######
# R ##
# MH&#
# &SS#
######

